19 17
###################
#......#####......#
#...#........#....#
#..#..........#...#
#..#..........#...#
#..#..........#...#
#...#........#....#
#..#..........#...#
#.......sss.......#
#.................#
#.....s.....s.....#
#.................#
#.................#
#.................#
#........p........#
#.................#
###################